"a" = (/turf/unsimulated/mask,/area/valSal_port/caves/deep)
"e" = (/obj/random/hostile/cave,/turf/floor/rock/volcanic,/area/valSal_port/caves/deep)
"f" = (/obj/effect/spider/spiderling/mundane,/obj/structure/flora/plant/random_mushroom,/turf/floor/dirt,/area/valSal_port/caves/deep)
"g" = (/obj/random/hostile/cave,/turf/floor/rock/basalt,/area/valSal_port/caves/deep)
"h" = (/obj/effect/decal/cleanable/cobweb,/turf/floor/dirt,/area/valSal_port/caves/deep)
"i" = (/obj/effect/decal/cleanable/cobweb2{dir = 1},/obj/item/remains/human,/turf/floor/rock/basalt,/area/valSal_port/caves/deep)
"j" = (/obj/effect/spider/stickyweb,/turf/floor/dirt,/area/valSal_port/caves/deep)
"l" = (/obj/effect/decal/cleanable/cobweb2{dir = 1},/turf/floor/dirt,/area/valSal_port/caves/deep)
"m" = (/mob/living/simple_animal/mushroom{name = "Shiitake"; desc = "He's a real fun guy!"},/turf/floor/rock/basalt,/area/valSal_port/caves/deep)
"o" = (/obj/effect/spider/stickyweb,/obj/item/remains/human,/turf/floor/dirt,/area/valSal_port/caves/deep)
"q" = (/turf/floor/rock/volcanic,/area/valSal_port/caves/deep)
"r" = (/obj/structure/flora/plant/random_mushroom/glowing,/turf/floor/rock/basalt,/area/valSal_port/caves/deep)
"s" = (/obj/effect/spider/stickyweb,/obj/item/remains/human,/mob/living/human/corpse,/turf/floor/dirt,/area/valSal_port/caves/deep)
"u" = (/obj/effect/decal/cleanable/cobweb2,/turf/floor/dirt,/area/valSal_port/caves/deep)
"v" = (/mob/living/simple_animal/hostile/giant_spider/guard/cave,/turf/floor/dirt,/area/valSal_port/caves/deep)
"w" = (/obj/structure/flora/plant/random_mushroom,/turf/floor/dirt,/area/valSal_port/caves/deep)
"x" = (/obj/abstract/ramp_sculptor/east,/turf/floor/rock/basalt,/area/valSal_port/caves/deep)
"y" = (/turf/floor/dirt,/area/valSal_port/caves/deep)
"z" = (/turf/unsimulated/floor/lava,/area/valSal_port/caves/deep)
"A" = (/obj/effect/decal/cleanable/cobweb2{dir = 1},/mob/living/simple_animal/hostile/giant_spider/guard/cave,/turf/floor/dirt,/area/valSal_port/caves/deep)
"C" = (/obj/item/cash/imperial/regalis,/obj/item/cash/imperial/regalis,/obj/item/cash/imperial/regalis,/obj/item/cash/imperial/regalis,/obj/item/cash/imperial/regalis,/obj/structure/closet/crate/chest,/turf/floor/dirt,/area/valSal_port/caves/deep)
"D" = (/obj/structure/flora/tree/softwood/towercap,/turf/floor/rock/basalt,/area/valSal_port/caves/deep)
"E" = (/obj/effect/spider/stickyweb,/turf/wall/natural/dirt,/area/valSal_port/caves/deep)
"G" = (/obj/structure/flora/plant/random_mushroom,/turf/floor/rock/volcanic,/area/valSal_port/caves/deep)
"H" = (/obj/effect/decal/cleanable/cobweb,/obj/effect/decal/cleanable/cobweb2{dir = 1},/turf/floor/dirt,/area/valSal_port/caves/deep)
"I" = (/obj/structure/flora/plant/random_mushroom,/turf/floor/rock/basalt,/area/valSal_port/caves/deep)
"J" = (/obj/effect/spider/spiderling/mundane,/turf/floor/dirt,/area/valSal_port/caves/deep)
"K" = (/obj/effect/decal/cleanable/cobweb,/obj/effect/spider/spiderling/mundane,/turf/floor/dirt,/area/valSal_port/caves/deep)
"L" = (/obj/random/hostile/cave,/turf/floor/shrouded/tar,/area/valSal_port/caves/deep)
"N" = (/turf/floor/rock/basalt,/area/valSal_port/caves/deep)
"O" = (/obj/structure/flora/plant/random_mushroom/glowing,/turf/floor/rock/sand,/area/valSal_port/caves/deep)
"Q" = (/obj/effect/decal/cleanable/cobweb2{dir = 1},/turf/floor/rock/basalt,/area/valSal_port/caves/deep)
"S" = (/turf/floor/shrouded/tar,/area/valSal_port/caves/deep)
"T" = (/turf/wall/natural/dirt,/area/valSal_port/caves/deep)
"U" = (/obj/effect/decal/cleanable/cobweb2,/turf/floor/rock/basalt,/area/valSal_port/caves/deep)
"X" = (/turf/unsimulated/dark_filler,/area/valSal_port/caves/deep)
"Y" = (/turf/floor/rock/sand,/area/valSal_port/caves/deep)
"Z" = (/obj/effect/spider/stickyweb,/turf/floor/rock/basalt,/area/valSal_port/caves/deep)

(1,1,1) = {"
XXXXXXXXXXXXXXXXXXXXXXXXXXXXXXXXXXXXXXXXXXXXXXXXXXXXXXXXXXXXXXXXXXXXXXXXXXXXXXXXXXXXXXXXXXXXXXXXXXXXXXXXXXXXXXXXXXXXXXXXXXXXXXXXXXXXXXXXXXXXXXXXXXXXXX
XXXXXXXXXXXXXXXXXXXXXXXXXXXXXXXXXXXXXXXXXXXXXXXXXXXXXXXXXXXXXXXXXXXXXXXXXXXXXXXXXXXXXXXXXXXXXXXXXXXXXXXXXXXXXXXXXXXXXXXXXXXXXXXXXXXXXXXXXXXXXXXXXXXXXX
XXXXXXXXXXXXXXXXXXXXXXXXXXXXXXXXXXXXXXXXXXXXXXXXXXXXXXXXXXXXXXXXXXXXXXXXXXXXXXXXXXXXXXXXXXXXXXXXXXXXXXXXXXXXXXXXXXXXXXXXXXXXXXXXXXXXXXXXXXXXXXXXXXXXXX
XXXXXXXXXXXXXXXXXXXXXXXXXXXXXXXXXXXXXXXXXXXXXXXXXXXXXXXXXXXXXXXXXXXXXXXXXXXXXXXXXXXXXXXXXXXXXXXXXXXXXXXXXXXXXXXXXXXXXXXXXXXXXXXXXXXXXXXXXXXXXXXXXXXXXX
XXXXXXXXXXXXXXXXXXXXXXXXXXXXXXXXXXXXXXXXXXXXXXXXXXXXXXXXXXXXXXXXXXXXXXXXXXXXXXXXXXXXXXXXXXXXXXXXXXXXXXXXXXXXXXXXXXXXXXXXXXXXXXXXXXXXXXXXXXXXXXXXXXXXXX
XXXXXXXXXXXXXXXXXXXXXXXXXXXXXXXXXXXXXXXXXXXXXXXXXXXXXXXXXXXXXXXXXXXXXXXXXXXXXXXXXXXXXXXXXXXXXXXXXXXXXXXXXXXXXXXXXXXXXXXXXXXXXXXXXXXXXXXXXXXXXXXXXXXXXX
XXXXXXXXXXXXXXXXXXXXXXXXXXXXXXXXXXXXXXXXXXXXXXXXXXXXXXXXXXXXXXXXXXXXXXXXXXXXXXXXXXXXXXXXXXXXXXXXXXXXXXXXXXXXXXXXXXXXXXXXXXXXXXXXXXXXXXXXXXXXXXXXXXXXXX
XXXXXXXaaaaaaaaaaaaaaaaaaaaaaaaaaaaaaaaaaaaaaaaaaaaaaaaaaaaaaaaaaaaaaaaaaaaaaaaaaaaaaaaaaaaaaaaaaaaaaaaaaaaaaaaaaaaaaaaaaaaaaaaaaaaaaaaaaaaaaaaXXXXXXX
XXXXXXXaaaaaaaaNNNNNDNNNNINNrNNNNNaaaaaaaaaaaaaaaaaaaaaaaaaaaaaaaaaaaaaaaaaaaaaaaaaaaaaaaaaaaaaaaaaaaaaaaaaaaaaaaaaaaaaaaaaaaaaaaaaaaaaaaaaaaaaXXXXXXX
XXXXXXXaaaaaNNrNNNNNNNgNNNNNNNNSSNNNaaaaaaaaaaaaaaaaaaaaaaaaaaaaaaaaaaaaaaaaaaaaaaaaaaaaaaaaaaaaaaaaaaaaaaaaaaaaaaaaaaaaaaaaaaaaaaaaaaaaaaaaaaaXXXXXXX
XXXXXXXaaNNNNNNNzzzzzzzzzzzzzzzzSSSNNNaaaaaaaaaaaaaaaaaaaaaaaaaaaaaaaaaaaaaaaaaaaaaaaaaaaaaaaaaaaaaaaaaaaaaaaaaaaTTTTTaaaaaaaaaaaaaaaaaaaaaaaaaXXXXXXX
XXXXXXXaNSSSSzzzzzzzzzzzzzzzzzzzzzzNNNNraaaaaaaaaaaaaaaaaaaaaaaaaaaaaaaaaaaaaaaaaaaaaaaaaaaaaaaaaaaaaaaaaaaaaaaaTTYYOTaaaaaaaaaaaaaaaaaaaaaaaaaXXXXXXX
XXXXXXXaISzzzzzzzzzzzzzzzzzzzzzzzzzzzNNNNNaaaaaaaaaaaaaaaaaaaaaaaaaaaaaaaaaaaaaaaaaaaaaaaaaaaaaaaaaaaaaaaaaaaaaTTYYYYTTaaaaaaaaaaaaaaaaaaaaaaaaXXXXXXX
XXXXXXXzzzzzzzzzzzzzzzzzzzzzzzzzzzzzzzzNNNINaaaaaaaaaaaaaaaaaaaaaaaaaaaaaaaaaaaaaaaaaaaaaaaaaaaaaaaaaaaaaaaaaaaTYOYYYYTaaaaaaaaaaaaaaaaaaaaaaaaXXXXXXX
XXXXXXXarNNNzzzzzzzzzzzzzzzzSSNzzzzzzzzzzzNNNNaaaaaaaaaaaaaaaaaaaaaaaaaaaaaaaaaaaaaaaaaaaaaaaaaTTTTTTTaaaaaaaaaTYYYYYYTTaaaaaaaaaaaaaaaaaaaaaaaXXXXXXX
XXXXXXXaaNNNNNzzzzazzzzzzNSSSNNNNNNNzzzzzzzzSSSSaaaaaaaaaaaaaaaaaaaaaaaaaaaaaaaaaaaaaaaaaaaaaaaTYYYOYTTaaaaaaaaTYYYYYYOTaaaaaaaaaaaaaaaaaaaaaaaXXXXXXX
XXXXXXXaaaNNDNNNzzzzzzNNNNNNrNNNDNNNNNNzzzzzaaaSSSaaaaaaaaaaaaaaaaaaaaaaaaaaaaaaaaaaaaaaaaaaaaaTYYYYYYTaaaaaaaaTTYYYYYYTaaaaaaaaaaaaaaaaaaaaaaaXXXXXXX
XXXXXXXaaaaNNNNNNNNNNNNNNNNaaNNNNNNNNINNNzzzzzaaaSSNaaaaaaaaaaaaaaaaaaaaaaaaaaaaaaaaaaaaaaaaaaaTYYYYYYNNNaaaaaaaTOYYYTTTaaaaaaaaaaaaaaaaaaaaaaaXXXXXXX
XXXXXXXaaaaaNNNNNNINNNNNaaaaaaaaaaaaNNNNNrazzzzaaaaNrDaaaaaaaaaaaaaaaaaaaaaaaaaaaaaaaaaaaaaaaaaTYYYYYOTaNNaaaaaaaTYYYTaaaaaaaaaaaaaaaaaaaaaaaaaXXXXXXX
XXXXXXXaaaaaaaNrNNNNNaaaaaaaaaaaaaaaaaNNNNaaazzzzaaaaaaaaaaaaaaaaaaaaaaaaaaaaaaaaaaaaaaaaaaaaaaTTOYYYTTaaNNaaaaaTTYOTTaaaaaaaaaaaaaaaaaaaaaaaaaXXXXXXX
XXXXXXXaaaaaaaaNNNNaaaaaaaaaaaaaaaaaaaaNgNNaaaazzzzaaaaaaaaaaaaaaaaaaaaaaaaaaaaaaaaaaaaaaaaaaaaaTTTTTTaaaaNNaaNNNYYTTaaaaaaaaaaaaaaaaaaaaaaaaaaXXXXXXX
XXXXXXXaaaaaaaaNNNaaaaaaaaaaaaaaaaaaaaaaNNNNaaaaazzzzaaaaaaaaaaaaaaaaaaaaaaaaaaaaaaaaTTTTTTaaaaaaaaaaaaaaaNNNNNaTTTTaaaaaaaaaaaaaaaaaaaaaaaaaaaXXXXXXX
XXXXXXXaaaaaaaaNNNaaaaaaaaaaaaaaaaaaaaaaaNNNNaaaaaazzzzzaaaaaaaaaaaaaaaaaaaaaaaaaaaaaTYYOYTTaaaaaNNNrNNNNNNNNNaaaaaaaaaaaaaaaaaaaaaaaaaaaaaaaaaXXXXXXX
XXXXXXXaaaaaaaaaNNaaaaaaaaaaaaaaaaaaaaaaaaNNDNaaaaaaaazzzzzaaaaaaaaaaaaaaaaaaaaaaaaaaTYYYYYTaaNNNNDNNNNNNNNNINNNNaaaaaaTTTTTaaaaaaaaaaaaaaaaaaaXXXXXXX
XXXXXXXaaaaaaaaaNNaaaaaaaaaaaaaaaaaaaaaaaaaNNNNaaaaaaaaazzzzzzaaaaaaaaaaaaaaaaaaaaaaTTOYYYYNNNNNNNNNNNNNDNNNNNNNNNaaaTTTYYOTTaaaaaaaaaaaaaaaaaaXXXXXXX
XXXXXXXaaaaaaaaaNNNaaaaaaaaaaaaaaaaaaaaaaaaaNNNNaaaaaaaaaazzzzzzaaaaaaaaaaaaaaaaaaaaTYYYYYYTaNNDNNNNNNNNNNNNNNDNNNaaaTYYYYYYTaaaaaaaaaaaaaaaaaaXXXXXXX
XXXXXXXaaaaaaaaaaDNNaaaaaaaaaaaaaaaaaaaaaaaaaNNNNaaaaaaaaaaazzzzzaaaaaaaaaaaaaaaaaaaTYYYYYYTaNNNNNINNNrNNNNNNNNNNNNaaTYYYYYYTTaaaaaaaaaaaaaaaaaXXXXXXX
XXXXXXXaaaaaaaaaaaNNNaaaaaaaaaaaaaaaaaaaaaaaaaaNNNNaaaaaaaaaaaazzzaaaaaaaaaaaaaaaaaaTTTYOYTTaaNNNNNNNNNNNNNNNNmNNNNaaTOYYYYYYTaaaaaaaaaaaaaaaaaXXXXXXX
XXXXXXXaaaaaaaaaaaaNNNaaaaaaaaaaaaaaaaaaaaaaaaaaNNNNDaaaaaaaaaaazzzaaaaaaaaaaaaaaaaaaaTTTTTaaaaNNNNNNNNNNNNNNNrNNNNaaTYYYYYYYTaaaaaaaaaaaaaaaaaXXXXXXX
XXXXXXXaaaaaaaaaaaaarNNNNaaaaaaaaaaaaaaaaaaaaaaaaNNNNNNaaaaaaaaaaazzaaaaaaaaaaaaaaaaaaaaaaaaaaNNNNaaaNaaaNNNNNNNNNNNNNYYYYYOYTTaaaaaaaaaaaaaaaaXXXXXXX
XXXXXXXaaaaaaaaaaaaaaaNNNNNNNaaaaaaaaaaaaaaaaaaaNNNNrNNNNaaaaaaaaazzaaaaaaaaaaaaaaaaaaaaaaaaNNNNaaaTTNTTaaNNNDNNNNaaTTYYYYYYYYTaaaaaaaaaaaaaaaaXXXXXXX
XXXXXXXaaaaaaaaaaaaaaaaaaNNNNNNNaaaaaaaaaaaaaaNNINNNNNNNNNNaaaaaaaazzaaaaaaaaaaaaaaaaaaaaaaNNNNaaaaTYYYTTaaNNNNNNaaaTYOYYYYYYYTaaaaaaaaaaaaaaaaXXXXXXX
XXXXXXXaaaaaaaaaaaaaaaaaaaaaaaNNNNaaaaaaaaaNNNNNNNaaaNNNNNNNNaaaaaaazaaaaaaaaaaaaaaaaaaaaaINNNaaaaTTOYYOTaaaaNNNaaaaTYYYYYYYYYTaaaaaaaaaaaaaaaaXXXXXXX
XXXXXXXaaaaaaaaaaaaaaaaaaaaaaaaaINNraaaaaDNNaaaaaaaaaaaaNNNNNNNaaaaazzaaaaaaaaaaaaaaaaaaaNNNaaaaaaTYYYYYTaaaaaaaaaaaTYYYYYYYYYTaaaaaaaaaaaaaaaaXXXXXXX
XXXXXXXaaaaaaaaaaaaaaaaaaaaaaaaaaaNNNNaaaaaaaaaaaaaaaaaaaaNNNNNNaaaaazaaaaaaaaaaaaaaaaaDNNNaaaaaaaTYYYYTTaaaaaaaaaaaTTTYYYYYOTTaaaaaaaaaaaaaaaaXXXXXXX
XXXXXXXaaaaaaaaaaaaaaaaaaaaaaaaaaaaaNNNNaaaaaaaaaaaaaaaaaaaaNNNNNaaaazzaaaaaaaaaaaaaaaaNNNaaaaaaaaTTYOTTaaaaaaaaaaaaaaTOYYYYYTaaaaaaaaaaaaaaaaaXXXXXXX
XXXXXXXaaaaaaaaaaaaaaaaaaaaaaaaaaaaaaaNNNaaaaaaaaaaaaaaaaaaaaNDNNNaaazzaaaaaaaaaaaaaaaNNNaaaaaaaaaaTTTTaaaaaaaaaaaaaaaTTTTTTTTaaaaaaaaaaaaaaaaaXXXXXXX
XXXXXXXaaaaaaaaaaaaaaaaaaaaaaaaaaaaaaaaagNaaaaaaaaaaaaaaaaaaaaNNNNNaaazaaaaaaaaaaaaaarNNNaaaaaaaaaaaaaaaaaaaaaaaaaaaaaaaaaaaaaaaaaaaaaaaaaaaaaaXXXXXXX
XXXXXXXaaaaaaaaaaaaaaaaaaaaaaaaaaaaaaaaaaNaaaaaaaaaaaaaaaaaaaaaNNNNNaazzaaaaaaaaaaaaNNNNNaaaaaaaaaaaaaaaaaaaaaaaaaaaaaaaaaaaaaaaaaaaaaaaaaaaaaaXXXXXXX
XXXXXXXaaaaaaaaaaaaaaaaaaaaaaaaaaaaaaaaaaNNaaaaaaaaaaaaaaaaaaaaaaNNNNazzaaaaaaaaaaaaNNNDNNaaaaaaaaaaaaaaaaaaaaaaaaaaaaaaaaaaaaaaaaaaaaaaaaaaaaaXXXXXXX
XXXXXXXaaaaaaaaaaaaaaaaaaaaaaaaaaaaaaaaaaaNaaaaaaaaaaaaaaaaaaaaaaaNNrNazaaaaaaaaaaaaNNNNNNNNaaaaaaaaaaaaaaaaaaaaaaaaaaaaaaaaaaaaaaaaaaaaaaaaaaaXXXXXXX
XXXXXXXaaaaaaaaaaaaaaaaaaaaaaaaaaaaaaaaaaaDaaaaaaaaaaaaaaaaaaaaaaaaNINNzaaaaaaaaaaaaNNNNNNNNNNaaaaaaaaaaaaaaaaaaaaaaaaaaaaaaaaaaaaaaaaaaaaaaaaaXXXXXXX
XXXXXXXaaaaaaaaaaaaaaaaaaaaaaaaaaaaaaaaaaaaaaaaaaaaaaaaaaaaaaaaaaaaaNNNzNaaaaaaaaaaaNNNaaaaaarNaaaaaaaaaaaaaaaaaaaaaaaaaaaaaaaaaaaaaaaaaaaaaaaaXXXXXXX
XXXXXXXaaaaaaaaaaaaaaaaaaaaaaaaaaaaaaaaaaaaaaaaaaaaaaaaaaaaaaaaaaaaaaNNzNNNaaaaaaaaaNNaaaaaaaaaaaaaaaaaaaaaaaaaaaaaaaaaaaaaaaaaaaaaaaaaaaaaaaaaXXXXXXX
XXXXXXXaaaaaaaaaaaaaaaaaaaaaaaaaaaaaaaaaaaaaaaaaaaaaaaaaaaaaaaaaaaaaaaazNNNDaaaaaaaNNNaaaaaaaaaaaaaaaaaaaaaaaaaaaaaaaaaaaaaaaaaaaaaaaaaaaaaaaaaXXXXXXX
XXXXXXXaaaaaaaaaaaaaaaaaaaaaaaaaaaaaaaaaaaaaaaaaaaaaaaaaaaaaaaaaaaaaaazzaNNNNNNNNNNNNNaaaaaaaaaaaaaaaaaaaaaaaaaaaaaaaaaaaaaaaaaaaaaaaaaaaaaaaaaXXXXXXX
XXXXXXXaaaaaaaaaaaaaaaaaaaaaaaaaaaaaaaaaaaaaaaaaaaaaaaaaaaaaaaaaaaaaaazzaaNNNNNNNNNNNNNaaaaaaaaaaaaaaaaaaaaaaaaaaaaaaaaaaaaaaaaaaaaaaaaaaaaaaaaXXXXXXX
XXXXXXXaaaaaaaaaaaaaaaaaaaaaaaaaaaaaaaaaaaaaaaaaaaaaaaaaaaaaaaaaaaaaazzaaaaNNNNNNNNNNNNaaaaaaaaaaaaaaaaaaaaaaaaaaaaaaaaaaaaaaaaaaaaaaaaaaaaaaaaXXXXXXX
XXXXXXXaaaaaaaaaaaaaaaaaaaaaaaaaaaaaaaaaaaaaaaaaaaaaaaaaaaaaaaaaaaazzzaaaaNNNNNNNaaNNNNaaaaaaaaaaaaaaaaaaaaaaaaaaaaaaaaaaaaaaaaaaaaaaaaaaaaaaaaXXXXXXX
XXXXXXXaaaaaaaaaaaaaaaaaaaaaaaaaaaaaaaaaaaaaaaaaaaaaaaaaaaaaaaaaazzzzaaaaNNNNNNaaaaNNNNaaaaaaaaaaaaaaaaaaaaaaaaaaaaaaaaaaaaaaaaaaaaaaaaaaaaaaaaXXXXXXX
XXXXXXXaaaaaaaaaaaaaaaaaaaaaaaaaaaaaaaaaaaaaaaaaaaaaaaaaaaaaazzzzzaaaaaaDNNNNNaaaaaNNNNaaaaaaaaaaaaaaaaaaaaaaaaaaaaaaaaaaaaaaaaaaaaaaaaaaaaaaaaXXXXXXX
XXXXXXXaaaaaaaaaaaaaaaaaaaaaaaaaaaaaaaaaaaaaaaaaaaaaaaaaaaazzzzzaaaaaaaNNNNNaaaaaaaaNNNNaaaaaaaaaaaaaaaaaaaaaaaaaaaaaaaaaaaaaaaaaaaaaaaaaaaaaaaXXXXXXX
XXXXXXXaaaaaaaaaaaaaaaaaaaaaaaaaaaaaaaaaaaaaaaaaaaaaaazzzzzzzaaaaaaaaaNNNNNNaaaaaaaaNNNNaaaaaaaaaaaaaaaaaaaaaaaaaaaaaaaaaaaaaaaaaaaaaaaaaaaaaaaXXXXXXX
XXXXXXXaaaaaaaaaaaaaaaaaaaaaaaaaaaaaaaaaaaaaaaaaaaaazzzzzaaaaaaaaaaaNNINNNaaaaaaaaaaNNNNaaaaaaaaaaaaaaaaaaaaaaaaaaaaaaaaaaaaaaaaaaaaaaaaaaaaaaaXXXXXXX
XXXXXXXaaaaaaaaaaaaaaaaaaaaaaaaaaaaaaaaaaaaaaaaaazzzzzaaaaaaaaaaaaaNNNNraaaaaaaaaaaaNNNNNaaaaaaaaaaaaaaaaaaaaaaaaaaaaaaaaaaaaaaaaaaaaaaaaaaaaaaXXXXXXX
XXXXXXXaaaaaaaaaaaaaaaaaaaaaaaaaaaaaaaaaaaaaaaaazzzzaaaaaaaaaaaaNNNNNNaaaaaaaaaaaaaaNNNNNNaaaaaaaaaaNDaaaaaaaaaaaaaaaaaaaaaaaaaaaaaaaaaaaaaaaaaXXXXXXX
XXXXXXXaaaaaaaaaaaaaaaaaaaaaaaaaaaaaaaaaaaaaaaazzzaaaaaaaaaNNNNNNNNNaaaaaaaaaaaaaaaaNNNNNNNNaaaaaaaNNaaaaaaaaaaaaaaaaaaaaaaaaaaaaaaaaaaaaaaaaaaXXXXXXX
XXXXXXXaaaaaaaaaaaaaaaaaaaaaaaaaaaaaaaaaaaaaaazzzaaaaaaaNNNNNNgNNNaaaaaaaaaaaaaaaaaaNNNNNNNNNNaaaaNINaaaaaaaaaaaaaaaaaaaaaaaaaaaaaaaaaaaaaaaaaaXXXXXXX
XXXXXXXaaaaaaaaaaaaaaaaaaaaaaaaaaaaaaaaaaaaaazzzaaaaNNrNNNNNNNNNaaaaaaaaaaaaaaaaaaaaaNNNNNNNNNNNNNNNaaaaaaaaaaaaaaaaaaaaaaaaaaaaaaaaaaaaaaaaaaaXXXXXXX
XXXXXXXaaaaaaaaaaaaaaaaaaaaaaaaaaaaaaaaaaaaazzzzaNNNNNNNNNNNaaaaaaaaaaaaaaaaaaaaaaaaaaaaNNNNNNNNNNaaaaaaaaaaaaaaaaaaaaaaaaaaaaaaaaaaaaaaaaaaaaaXXXXXXX
XXXXXXXaaaaaaaaaaaaaaaaaaaaaaaaaaaaaaaaaaaazzzzNNNNNNNNaaaaaaaaaaaaaaaaaaaaTTTTTTTaaaaaaaNNNNNNNNNaaaaaaaaaaaaaaaaaaaaaaaaaaaaaaaaaaaaaaaaaaaaaXXXXXXX
XXXXXXXaaaaaaaaaaaaaaaaaaaaaaaaaaaaaaaaaaazzzzNNNNNaNNaaaaaaaaaaaaaaaaaaTTTThyoywTTTTaaaaNNNNNNNrNaaaaaaaaaaaaaaaaaaaaaaaaaaaaaaaaaaaaaaaaaaaaaXXXXXXX
XXXXXXXaaaaaaaaaaaaaaaaaaaaaaaaaaaaaaaqqqzzzzNNNNaaaaNaaaaaaaaaaaaaaTTTTTKyyjyyJyyyyTaaaaaaNDNNNNNaaaaaaaaaaaaaaaaaaaaaaaaaaaaaaaaaaaaaaaaaaaaaXXXXXXX
XXXXXXXaaaaaaaaaaaaaaaaaaaaaaaaaaaaaqqqqzzzzNrNNaaaaaZUaaaaaaaaaaaaTThyyjyTTTTTTTTljTaaaaaaNNNNNNaaaaaaaaaaaaaaaaaaaaaaaaaaaaaaaaaaaaaaaaaaaaaaXXXXXXX
XXXXXXXaaaaaaaaaaaaaaaaaaaaaaaaaaaaqqqqzzzaaNINaaaaaaaQUaaaaaaaaaaTTTyyTTTTThjyujTTyTTaaaaaNNNNNaaaaaaaaaaaaaaaaaaaaaaaaaaaaaaaaaaaaaaaaaaaaaaaXXXXXXX
XXXXXXXaaaaaaaaaaaaaaaaaaaaaaaaaqqqqqzzzzaaaNNNaaaaaaaaiuaaaaaaaaaTTyyTTjTjyyyvyyjTlyTaaaaaNNNNNaaaaaaaaaaaaaaaaaaaaaaaaaaaaaaaaaaaaaaaaaaaaaaaXXXXXXX
XXXXXXXaaaaaaaaaaaaaaaaaaaaqqqqqGqqzzzzqqaaaNNNaaaaaaaaaluaaaTTaaTThyTThJTlyJyjTTTTTyTaaaaaaNNNaaaaaaaaaaaaaaaaaaaaaaaaaaaaaaaaaaaaaaaaaaaaaaaaXXXXXXX
XXXXXXXaaaaaaaaaaaaaaaaqqqqqqqqqqzzzzzqqaaaaNDNaaaaaaaaaalyjhyTTTTjjTTjyyTTTjyTTujTTJTTaaaaaNNNaaaaaaaaaaaaaaaaaaaaaaaaaaaaaaaaaaaaaaaaaaaaaaaaXXXXXXX
XXXXXXXaaaaaaaaaaaaaqqqqqqqqqqqzzzzzzqqqaaaaNNNaaaaaaaaaaaaayyyjhyyyTjhvyyjTTyysyJTTyjTaaaaaNNNaaaaaaaaaaaaaaaaaaaaaaaaaaaaaaaaaaaaaaaaaaaaaaaaXXXXXXX
XXXXXXXaaaaaaaaaaqqqqqqqqzzzzzzzzzzSqqqaaaaaNNNaaaaaaaaaaaaaTTlywyJTTyywjyyTTTwyjTTTyyTaaaaaNINaaaaaaaaaaaaaaaaaaaaaaaaaaaaaaaaaaaaaaaaaaaaaaaaXXXXXXX
XXXXXXXaaaaaaaaqqqqeqqzzzzzzzzzzzzSSqqaaaaaaaNNNaaaaaaaaaaaaaTTlyyyThJjyuTTTjTyJTTjTywTaaaaaNNNaaaaaaaaaaaaaaaaaaaaaaaaaaaaaaaaaaaaaaaaaaaaaaaaXXXXXXX
XXXXXXXaaaaaaaqqqqqqqzzzzzzzzzzzzSSqqqaaaaaaaNNNaaaaaaaaaaaaaaTTjyyTyTTTTToCuToyTjyTyyTaaaaaNNNaaaaaaaaaaaaaaaaaaaaaaaaaaaaaaaaaaaaaaaaaaaaaaaaXXXXXXX
XXXXXXXaaaaaaqSSqqqqzzzzzzzzzzzzzzSqqqaaaaaaaNNNNaaaaaaaaaaaaaaTTyyTjujTTHyvyyyyyvyTjyTaaaaaNNNaaaaaaaaaaaaaaaaaaaaaaaaaaaaaaaaaaaaaaaaaaaaaaaaXXXXXXX
XXXXXXXaaaaaqqSSqqzzzzzzzzzzzzzzzzSSGqaaaaaaaNNNNaaaaaaaaaaaaaaaTyyTTlJyTTTyyjTTyjyTyyTaaaaaNNNaaaaaaaaaaaaaaaaaaaaaaaaaaaaaaaaaaaaaaaaaaaaaaaaXXXXXXX
XXXXXXXaaaaaqSSSSzzzzzzzzzzzzzzzzzzqqqqaaaaaaaNNNNaaaaaaaaaaaaaaTlyjTToyjuTjyTEJyujTyTTaaaaaNNNaaaaaaaaaaaaaaaaaaaaaaaaaaaaaaaaaaaaaaaaaaaaaaaaXXXXXXX
XXXXXXXaaaaqqSSSzzzzzzzzzzzzzzzzzzzqqqqaaaaaaaaNNNNaaaaaaaaaaaaaTTlyuTTTAyJwTTyyjyTTyTTaaaaNNNNaaaaaaaaaaaaaaaaaaaaaaaaaaaaaaaaaaaaaaaaaaaaaaaaXXXXXXX
XXXXXXXaaaaqGqSSzzzzzzzzzzzzzzzzzzzqqqqaaaaaaaaarNNNNaaaaaaaaaaaaTTywyuTTTTTTTTTTTTjyoTaaaaNNNNaaaaaaaaaaaaaaaaaaaaaaaaaaaaaaaaaaaaaaaaaaaaaaaaXXXXXXX
XXXXXXXaaaqqqqSzzzzzzzzzzzzzzzzzzzzqqqqaaaaaaaaaaNNNNNNaaaaaaaaaaaTjyyjyyyyyjhyjyyyfTTTaaaaNNNNaaaaaaaaaaaaaaaaaaaaaaaaaaaaaaaaaaaaaaaaaaaaaaaaXXXXXXX
XXXXXXXaaaqqqqzzzzzzzzzzzzzzzzzzzzzzqqqaaaaaaaaaaaaNNNNNaaaaaaaaaaTTTTTyyjyJyyyTTTTTTaaaaaNNNNNaaaaaaaaaaaaaaaaaaaaaaaaaaaaaaaaaaaaaaaaaaaaaaaNXXXXXXX
XXXXXXXaaqqqqzzzzzzzzzzzzzzzzzzzzzzzqqqaaaaaaaaaaaaaNNINNaaaaaaaaaaaaaTTTTTTTTTTaaaaaaaaaNNNNNaaaaaaaaaaaaaaaaaaaaaaaaaaaaaaaaaaaaaaaaaaaaaaaaNXXXXXXX
XXXXXXXaaqqqqzzzzzzzzzzzzzzzzzzzzzzzSqqaaaaaaaaaaaaaaaNNNNNaaaaaaaaaaaaaaaaaaaaaaaaaaaaaaNNNDraaaaaaaaaaaaaaaaaaaaaaaaaaaaaaaaaaaaaaaaaaaaaaaNNXXXXXXX
XXXXXXXaaqqqzzzzzzzzzzzzzzzzzzzzzzzzSqqaaaaaaaaaaaaaaaaNNNNNaaaaaaaaaaaaaaaaaaaaaaaaaaaaNNNNNNaaaaaaaaaaaaaaaaaaaaaaaaaaaaaaaaaaaaaaaaaaaaaaaNNXXXXXXX
XXXXXXXaaqqqzzzzzzzzzzzzzzzzzzzzzzzzSqqaaaaaaaaaaaaaaaaaNNNNNaaaaaaaaaaaaaaaaaaaaaaaaaaaNNNNNNaaaaaaaaaaaaaaaaaaaaaaaaaaaaaaaaaaaaaaaaaaaaaaNNNXXXXXXX
XXXXXXXaqqqqzzzzzzzzzzzzzzzzzzzzzzzzSqqaaaaaaaaaaaaaaaaaaNNNNNaaaaaaaaaaaaaaaaaaaaaaaaaaNNNNNaaaaaaaaaaaaaaaaaaaaaaaaaaaaaaaaaaaaaaaaaaaaaaaNrNXXXXXXX
XXXXXXXaqqqzzzzzzzzzzzzzzzzzzzzzzzzSSqqaaaaaaaaaaaaaaaaaaaNDNNNNaaaaaaaaaaaaaaaaaaaaaaaaNNgNNaaaaaaaaaaaaaaaaaaaaaaaaaaaaaaaaaaaaaaaaaaaaaaNNNNXXXXXXX
XXXXXXXaqqezzzzzzzzzzzzzzzzzzzzzzzzSSqqaaaaaaaaaaaaaaaaaaaaNNNNNNraaaaaaaaaaaaaaaaaaaaaNNNNNNaaaaaaaaaaaaaaaaaaaaaaaaaaaaaaaaaaaaaaaaaaaaaaNNNNXXXXXXX
XXXXXXXaqqqzzzzzzzzzzzzzzzzzzzzzzzzSSqaaaaaaaaaaaaaaaaaaaaaaaNNNNNNaaaaaaaaaaaaaaaaaaNNNNNNNNaaaaaaaaaaaaaaaaaaaaaaaaaaaaaaaaaaaaaaaaaaaaaNNNNNXXXXXXX
XXXXXXXaqqqqzzzzzzzzzzzzzzzzzzzzzzSLqqaaaaaaaaaaaaaaaaaaaaaaaaaNNNNNaaaaaaaaaaaaaaaNNNNNNNNNNaaaaaaaaaaaaaaaaaaaaaaaaaaaaaaaaaaaaaaaaaaaaNNNNNNXXXXXXX
XXXXXXXaaqqqzzzzzzzzzzzzzzzzzzzzzzSqqqaaaaaaaaaaaaaaaaaaaaaaaaaaaNNNNNNaaaaaaaaaNNNNNNNNNNNNNaaaaaaaaaaaaaaaaaaaaaaaaaaaaaaaaaaaaaaaaaaaNNNNNNNXXXXXXX
XXXXXXXaaqqqqzzzzzzzzzzzzzzzzzzzzqqqqaaaaaaaaaaaaaaaaaaaaaaaaaaaaaNNNNNNNNrNNNNNNNNNNINNNNNNNaaaaaaaaaaaaaaaaaaaaaaaaaaaaaaaaaaaaaaaaaaNNNINNNNXXXXXXX
XXXXXXXaaqqqqzzzzzzzzzzzzzzzzzzqqqqqqaaaaaaaaaaaaaaaaaaaaaaaaaaaaaaNNNNNNNNNNNNNNNNNNNNNNNNNNNaaaaaaaaaaaaaaaaaaaaaaaaaaaaaaaaaaaaaaaaaNNNNNNNNXXXXXXX
XXXXXXXaaaqqqSSSzzzzzzzzzzzzzqqqqqqqaaaaaaaaaaaaaaaaaaaaaaaaaaaaaaNNNgNNNNNNNNNNNNNNNNNNNNNNNNaaaaaaaaaaaaaaaaaaaaaaaaaaaaaaaaaaaaaaaaNNgNNNNNNXXXXXXX
XXXXXXXaaaaaqqqSSSzzzzzzzzzqqqqqqqaaaaaaaaaaaaaaaaaaaaaaaaaaaaaaaNNNNNNNNDNNNNNNNNNNNNNNNNNNNNNaaaaaaaaaaaaaaaaaaaaaaaaaaaaaaaaaaaaaaNNNNNNaaaaXXXXXXX
XXXXXXXaaaaaaqqSSSSqqqqqqqqqqqqqqaaaaaaaaaaaaaaaaaaaaaaaaaaaaaaaNNNNNNNNNNNNNNNNNNNNNNNNNNNNNNNNaaaaaaaaaaaaaaaaaaaaaaaaaaaaaaaaaaaNNNNNNNaaaaaXXXXXXX
XXXXXXXaaaaaaaaqqqqqqqqqGqqqqqqaaaaaaaaaaaaaaaaaaaaaaaaaaaaaaaNNNNNNNNINNNNNNNNNNNaaaaNNNrNNNNNNNaaaaaaaaaaaaaaaaaaaaaaaaaaaaaaaaaNNNNNNaaaaaaaXXXXXXX
XXXXXXXaaaaaaaaaaqqqqqeqqqqqqaaaaaaaaaaaaaaaaaaaaaaaaaaaaaaNNNNNNNNNNNNNNNaaNNNNNNaaaaaaaNNNNNNNNNaaaaaaaaaaaaaaaaaaaaaaaaaaaaaaaNNNNNNaaaaaaaaXXXXXXX
XXXXXXXaaaaaaaaaaaaaaaaaaaaaaaaaaaaaaaaaaaaaaaaaaaaaaaaaNNNNNNNNNNNNNaaaaaaaaNNINNaaaaaaaaaNNNNNNIaaaaaaaaaaaaaaaaaaaaaaaaaaaaaNNNNNNNNaaaaaaaaXXXXXXX
XXXXXXXaaaaaaaaaaaaaaaaaaaaaaaaaaaaaaaaaaaaaaaaaaaaaaNNrNNNNNNNNNaaaaaaaaaaaaaNNNaaaaaaaaaaaaaNNNNaaaaaaaaaaaaaaaaaaaaaaaaaaaaNNNNNNNNNaaaaaaaaXXXXXXX
XXXXXXXaaaaaaaaaaaaaaaaaaaaaaaaaaaaaaaaaaaaaaaaaaaaaNNNNNNNNNNNaaaaaaaaaaaaaaaNNNaaaaaaaaaaaaaaaaNNaaaaaaaaaaaaaaaaaaaaaaaaaNNNNNNNINaaaaaaaaaaXXXXXXX
XXXXXXXaaaaaaaaaaaaaaaaaaaaaaaaaaaaaaaaaaaaaaaaaaaNNNNNNNNNNNaaaaaaaaaaaaaaaaaNNNaaaaaaaaaaaaaaaaaNNNaaaaaaaaaaaaaaaaaaaaaaNNNNNNNNNaaaaaaaaaaaXXXXXXX
XXXXXXXaaaaaaaaaaaaaaaaaaaaaaaaaaaaaaaaaaaaaaaaaaNNNNNNNNNNaaaaaaaaaaaaaaaaaaaNDNaaaaaaaaaaaaaaaaaNNNNNrNaaaaaaaaaaaaaaarNNNNNNNNaaaaaaaaaaaaaaXXXXXXX
XXXXXXXaaaaaaaaaaaaaaaaaaaaaaaaaaaaaaaaaaaaaaaaaNNNNNNNNNNaaaaaaaaaaaaaaaaaaaarNNaaaaaaaaaaaaaaaaaaaNNNNNNNNNNaaaaaaNNNNNNNNNNaaaaaaaaaaaaaaaaaXXXXXXX
XXXXXXXaaaaaaaaaaaaaaaaaaaaaaaaaaaaaaaaaaaaaaNNNNNINNNNNNaaaaaaaaaaaaaaaaaaaaaNNNaaaaaaaaaaaaaaaaaaaaaaNNNNNNNNNNNNNNNNNNNNNaaaaaaaaaaaaaaaaaaaXXXXXXX
XXXXXXXaaaaaaaaaaaaaaaaaaaaaaaaaaaaNDNNNNNNNNNNNNNNNNNNNNaaaaaaaaaaaaaaaaaaaaaNNNaaaaaaaaaaaaaaaaaaaaaaaaaaaNNNNNDNNNNNNNNaaaaaaaaaaaaaaaaaaaaaXXXXXXX
XXXXXXXaaaaaaaaaaaaaaaaaaaaaaaaNNNNNNNNNNNNNNNNNNNNNNNNaaaaaaaaaaaaaaaaaaaaaaaNNNaaaaaaaaaaaaaaaaaaaaaaaaaaaaNNNNNNNNNNaaaaaaaaaaaaaaaaaaaaaaaaXXXXXXX
XXXXXXXaaaaaaaaaaaaaaaaaaaaNNNNNNINNNNrNNNNNNNNNNNNNNNaaaaaaaaaaaaaaaaaaaaaaaNNNNaaaaaaaaaaaaaaaaaaaaaaaaaaaaNNNNNNNaaaaaaaaaaaaaaaaaaaaaaaaaaaXXXXXXX
XXXXXXXaaaaaaaaaaaaaaaaaaNNNNNNNNNNNNNNNNNINNNNNNNNNNaaaaaaaaaaaaaaaaaaaaaaaaNNNNNaaaaaaaaaaaaaaaaaaaaaaaaaaaNNgNNNaaaaaaaaaaaaaaaaaaaaaaaaaaaaXXXXXXX
XXXXXXXaaaaaaaaaaaaaaaaNNNrNNNNNaaaaaaaNNNNNNNNNNNNNNaaaaaaaaaaaaaaaaaaaaaaaNNNaNNNaaaaaaaaaaaaaaaaaaaaaaaaaaNNNNNaaaaaaaaaaaaaaaaaaaaaaaaaaaaaXXXXXXX
XXXXXXXaaaaaaaaaaaaaaNNNNNNNaaaaaaaaaaaaaaNNNNNNNNNraaaaaaaaaaaaaaaaaaaaaaaaNNaaNNNNNaaaaaaaaaaaaaaaaaaaaaaaaNNNNaaaaaaaaaaaaaaaaaaaaaaaaaaaaaaXXXXXXX
XXXXXXXaaaaaaaaaaaaNNNNNNaaaaaaaaaaaaaaaaaaaNNNNNNNaaaaaaaaaaaaaaaaaaaaaaaaNNNaaaNNNNNaaaaaaaaaaaaaaaaaaaaaaNNNNaaaaaaaaaaaaaaaaaaaaaaaaaaaaaaaXXXXXXX
XXXXXXXaaaaaaaaaaaNNIaaaaaaaaaaaaaaaaaaaaaaaNNNNNNNaaaaaaaaaaaaaaaaaaaaaaaNNNaaaaaNNINNNaaaaaaaaaaaaaaaaaaaNINNaaaaaaaaaaaaaaaaaaaaaaaaaaaaaaaaXXXXXXX
XXXXXXXaaaaaaaaaaNDaaaaaaaaaaaaaaaaaaaaaaaaNNNNNNNaaaaaaaaaaaaaaaaaaaaaaaaINaaaaaaaaNNNNNaaaaaaaaaaaaaaaNNrNNaaaaaaaaaaaaaaaaaaaaaaaaaaaaaaaaaaXXXXXXX
XXXXXXXaaaaaaaaaNNaaaaaaaaaaaaaaaaaaaaaaaaaNNNNNNNaaaaaaaaaaaaaaaaaaaaaaaNNNaaaaaaaaaNNNNNaaaaaaaaaaaaNNNNNaaaaaaaaaaaaaaaaaaaaaaaaaaaaaaaaaaaaXXXXXXX
XXXXXXXaaaaaaaaNNNaaaaaaaaaaaaaaaaaaaaaaaaaNNNNNNaaaaaaaaaaaaaaaaaaaaaaaNNNaaaaaaaaaaaNNNNaaaaaaaaaaNNNaaaaaaaaaaaaaaaaaaaaaaaaaaaaaaaaaaaaaaaaXXXXXXX
XXXXXXXaaaaaaaarNaaaaaaaaaaaaaaaaaaaaaaaaarNNNNNaaaaaaaaaaaaaaaaaaaaaaaNNNaaaaaaaaaaaaaaNNaaaaaaaaaaaaaaaaaaaaaaaaaaaaaaaaaaaaaaaaaaaaaaaaaaaaaXXXXXXX
XXXXXXXaaaaaaaaNaaaaaaaaaaaaaaaaaaaaaaaaaaNNNNNNaaaaaaaaaaaaaaaaaaaaaaNrNaaaaaaaaaaaaaaaNNaaaaaaaaaaaaaaaaaaaaaaaaaaaaaaaaaaaaaaaaaaaaaaaaaaaaaXXXXXXX
XXXXXXXaaaaaaaaaaaaaaaaaaaaaaaaaaaaaaaaaaaNNNNNNaaaaaaaaaaaaaaaaaaaaaNNNNaaaaaaaaaaaaaaaNNaaaaaaaaaaaaaaaaaaaaaaaaaaaaaaaaaaaaaaaaaaaaaaaaaaaaaXXXXXXX
XXXXXXXaaaaaaaaaaaaaaaaaaaaaaaaaaaaaaaaaaaNNNNNNaaaaaaaaaaaaaaaaaaaaaNNNaaaaaaaaaaaaaaaaNNaaaaaaaaaaaaaaaaaaaaaaaaaaaaaaaaaaaaaaaaaaaaaaaaaaaaaXXXXXXX
XXXXXXXaaaaaaaaaaaaaaaaaaaaaaaaaaaaaaaaaaNNNNNNaaaaaaaaaaaaaaaaaaaaaaNNaaaaaaaaaaaaaaaaaNNaaaaaaaaaaaaaaaaaaaaaaaaaaaaaaaaaaaaaaaaaaaaaaaaaaaaaXXXXXXX
XXXXXXXaaaaaaaaaaaaaaaaaaaaaaaaaaaaaaaaaaNNNNNNaaaaaaaaaaaaaaaaaaaaaaNNaaaaaaaaaaaaaaaaaNNaaaaaaaaaaaaaaaaaaaaaaaaaaaaaaaaaaaaaaaaaaaaaaaaaaaaaXXXXXXX
XXXXXXXaaaaaaaaaaaaaaaaaaaaaaaaaaaaaaaaaaNNNNNNaaaaaaaaaaaaaaaaaaaaaaNNaaaaaaaaaaaaaaaaaNNaaaaaaaaaaaaaaaaaaaaaaaaaaaaaaaaaaaaaaaaaaaaaaaaaaaaaXXXXXXX
XXXXXXXaaaaaaaaaaaaaaaaaaaaaaaaaaaaaaaaaaNNNNNNaaaaaaaaaaaaaaaaaaaaaaaINaaaaaaaaaaaaaaaaNNaaaaaaaaaaaaaaaaaaaaaaaaaaaaaaaaaaaaaaaaaaaaaaaaaaaaaXXXXXXX
XXXXXXXaaaaaaaaaaaaaaaaaaaaaaaaaaaaaaaaaaNNNNINaaaaaaaaaaaaaaaaaaaaaaaNNaaaaaaaaaaaaaaaaNNaaaaaaaaaaaaaaaaaaaaaaaaaaaaaaaaaaaaaaaaaaaaaaaaaaaaaXXXXXXX
XXXXXXXaaaaaaaaaaaaaaaaaaaaaaaaaaaaaaaaaaNNNNNNaaaaaaaaaaaaaaaaaaaaaaaaDNaaaaaaaaaaaaaaaINaaaaaaaaaaaaaaaaaaaaaaaaaaaaaaaaaaaaaaaaaaaaaaaaaaaaaXXXXXXX
XXXXXXXaaaaaaaaaaaaaaaaaaaaaaaaaaaaaaaaaaNNgNNNaaaaaaaaaaaaaaaaaaaaaaaaNNaaaaaaaaaaaaaaaNNaaaaaaaaaaaaaaaaaaaaaaaaaaaaaaaaaaaaaaaaaaaaaaaaaaaaaXXXXXXX
XXXXXXXaaaaaaaaaaaaaaaaaaaaaaaaaaaaaaaaaarNNNNNaaaaaaaaaaaaaaaaaaaaaaaaNNNaaaaaaaaaaaaaaNNaaaaaaaaaaaaaaaaaaaaaaaaaaaaaaaaaaaaaaaaaaaaaaaaaaaaaXXXXXXX
XXXXXXXaaaaaaaaaaaaaaaaaaaaaaaaaaaaaaaaaaNNNNNNaaaaaaaaaaaaaaaaaaaaaaaaaNNaaaaaaaaaaaaaaNNaaaaaaaaaaaaaaaaaaaaaaaaaaaaaaaaaaaaaaaaaaaaaaaaaaaaaXXXXXXX
XXXXXXXaaaaaaaaaaaaaaaaaaaaaaaaaaaaaaaaaaaNNNNNNaaaaaaaaaaaaaaaaaaaaaaaaaNaaaaaaaaaaaaaaNaaaaaaaaaaaaaaaaaaaaaaaaaaaaaaaaaaaaaaaaaaaaaaaaaaaaaaXXXXXXX
XXXXXXXaaaaaaaaaaaaaaaaaaaaaaaaaaaaaaaaaaaNNNNNNaaaaaaaaaaaaaaaaaaaaaaaaaaaaaaaaaaaaaaaNNaaaaaaaaaaaaaaaaaaaaaaaaaaaaaaaaaaaaaaaaaaaaaaaaaaaaaaXXXXXXX
XXXXXXXaaaaaaaaaaaaaaaaaaaaaaaaaaaaaaaaaaaNNNNNNraaaaaaaaaaaaaaaaaaaaaaaaaaaaaaaaaaaaaaNNaaaaaaaaaaaaaaaaaaaaaaaaaaaaaaaaaaaaaaaaaaaaaaaaaaaaaaXXXXXXX
XXXXXXXaaaaaaaaaaaaaaaaaaaaaaaaaaaaaaaaaaaaNNNNNNaaaaaaaaaaaaaaaaaaaaaaaaaaaaaaaaaaaaaNNaaaaaaaaaaaaaaaaaaaaaaaaaaaaaaaaaaaaaaaaaaaaaaaaaaaaaaaXXXXXXX
XXXXXXXaaaaaaaaaaaaaaaaaaaaaaaaaaaaaaaaaaaaNNNNNNaaaaaaaaaaaaaaaaaaaaaaaaaaaaaaaaaaNNNDaaaaaaaaaaaaaaaaaaaaaaaaaaaaaaaaaaaaaaaaaaaaaaaaaaaaaaaaXXXXXXX
XXXXXXXaaaaaaaaaaaaaaaaaaaaaaaaaaaaaaaaaaaaNNNNNNNaaaaaaaaaaaaaaaaaaaaaaaaaaaaaaaaNNrNaaaaaaaaaaaaaaaaaaaaaaaaaaaaaaaaaaaaaaaaaaaaaaaaaaaaaaaaaXXXXXXX
XXXXXXXaaaaaaaaaaaaaaaaaaaaaaaaaaaaaaaaaaaaaNNNNNNNaaaaaaaaaaaaaaaaaaaaaaaaaaaNNNNNNNaaaaaaaaaaaaaaaaaaaaaaaaaaaaaaaaaaaaaaaaaaaaaaaaaaaaaaaaaaXXXXXXX
XXXXXXXaaaaaaaaaaaaaaaaaaaaaaaaaaaaaaaaaaaaaaNNNNNNNNaaaaaaaaaaaaaaaaaaaaNNNNNNNNNaaaaaaaaaaaaaaaaaaaaaaaaaaaaaaaaaaaaaaaaaaaaaaaaaaaaaaaaaaaaaXXXXXXX
XXXXXXXaaaaaaaaaaaaaaaaaaaaaaaaaaaaaaaaaaaaaaaNNNNNNNNNNNNaaaaaaaaaaaaaaaaaaaaaaaaaaaaaaaaaaaaaaaaaaaaaaaaaaaaaaaaaaaaaaaaaaaaaaaaaaaaaaaaaaaaaXXXXXXX
XXXXXXXaaaaaaaaaaaaaaaaaaaaaaaaaaaaaaaaaaaaaaaaaaaNNNNNNNNNNNNNNNNNNNNaaaaaaaaaaaaaaaaaaaaaaaaaaaaaaaaaaaaaaaaaaaaaaaaaaaaaaaaaaaaaaaaaaaaaaaaaXXXXXXX
XXXXXXXaaaaaaaaaaaaaaaaaaaaaaaaaaaaaaaaaaaaaaaaaaaaaaaaaaaaNNNNNNNNNNNNraaaaaaaaaaaaaaaaaaaaaaaaaaaaaaaaaaaaaaaaaaaaaaaaaaaaaaaaaaaaaaaaaaaaaaaXXXXXXX
XXXXXXXaaaaaaaaaaaaaaaaaaaaaaaaaaaaaaaaaaaaaaaaaaaaaaaaaaaaaaaaaaaaaaaNNNNNNNNNNNNxNaaaaaaaaaaaaaaaaaaaaaaaaaaaaaaaaaaaaaaaaaaaaaaaaaaaaaaaaaaaXXXXXXX
XXXXXXXaaaaaaaaaaaaaaaaaaaaaaaaaaaaaaaaaaaaaaaaaaaaaaaaaaaaaaaaaaaaaaaaaaaaaaaaaaaaaaaaaaaaaaaaaaaaaaaaaaaaaaaaaaaaaaaaaaaaaaaaaaaaaaaaaaaaaaaaXXXXXXX
XXXXXXXaaaaaaaaaaaaaaaaaaaaaaaaaaaaaaaaaaaaaaaaaaaaaaaaaaaaaaaaaaaaaaaaaaaaaaaaaaaaaaaaaaaaaaaaaaaaaaaaaaaaaaaaaaaaaaaaaaaaaaaaaaaaaaaaaaaaaaaaXXXXXXX
XXXXXXXaaaaaaaaaaaaaaaaaaaaaaaaaaaaaaaaaaaaaaaaaaaaaaaaaaaaaaaaaaaaaaaaaaaaaaaaaaaaaaaaaaaaaaaaaaaaaaaaaaaaaaaaaaaaaaaaaaaaaaaaaaaaaaaaaaaaaaaaXXXXXXX
XXXXXXXaaaaaaaaaaaaaaaaaaaaaaaaaaaaaaaaaaaaaaaaaaaaaaaaaaaaaaaaaaaaaaaaaaaaaaaaaaaaaaaaaaaaaaaaaaaaaaaaaaaaaaaaaaaaaaaaaaaaaaaaaaaaaaaaaaaaaaaaXXXXXXX
XXXXXXXXXXXXXXXXXXXXXXXXXXXXXXXXXXXXXXXXXXXXXXXXXXXXXXXXXXXXXXXXXXXXXXXXXXXXXXXXXXXXXXXXXXXXXXXXXXXXXXXXXXXXXXXXXXXXXXXXXXXXXXXXXXXXXXXXXXXXXXXXXXXXXX
XXXXXXXXXXXXXXXXXXXXXXXXXXXXXXXXXXXXXXXXXXXXXXXXXXXXXXXXXXXXXXXXXXXXXXXXXXXXXXXXXXXXXXXXXXXXXXXXXXXXXXXXXXXXXXXXXXXXXXXXXXXXXXXXXXXXXXXXXXXXXXXXXXXXXX
XXXXXXXXXXXXXXXXXXXXXXXXXXXXXXXXXXXXXXXXXXXXXXXXXXXXXXXXXXXXXXXXXXXXXXXXXXXXXXXXXXXXXXXXXXXXXXXXXXXXXXXXXXXXXXXXXXXXXXXXXXXXXXXXXXXXXXXXXXXXXXXXXXXXXX
XXXXXXXXXXXXXXXXXXXXXXXXXXXXXXXXXXXXXXXXXXXXXXXXXXXXXXXXXXXXXXXXXXXXXXXXXXXXXXXXXXXXXXXXXXXXXXXXXXXXXXXXXXXXXXXXXXXXXXXXXXXXXXXXXXXXXXXXXXXXXXXXXXXXXX
XXXXXXXXXXXXXXXXXXXXXXXXXXXXXXXXXXXXXXXXXXXXXXXXXXXXXXXXXXXXXXXXXXXXXXXXXXXXXXXXXXXXXXXXXXXXXXXXXXXXXXXXXXXXXXXXXXXXXXXXXXXXXXXXXXXXXXXXXXXXXXXXXXXXXX
XXXXXXXXXXXXXXXXXXXXXXXXXXXXXXXXXXXXXXXXXXXXXXXXXXXXXXXXXXXXXXXXXXXXXXXXXXXXXXXXXXXXXXXXXXXXXXXXXXXXXXXXXXXXXXXXXXXXXXXXXXXXXXXXXXXXXXXXXXXXXXXXXXXXXX
XXXXXXXXXXXXXXXXXXXXXXXXXXXXXXXXXXXXXXXXXXXXXXXXXXXXXXXXXXXXXXXXXXXXXXXXXXXXXXXXXXXXXXXXXXXXXXXXXXXXXXXXXXXXXXXXXXXXXXXXXXXXXXXXXXXXXXXXXXXXXXXXXXXXXX
"}
